5 10
..........
..........
...XX.....
..........
...X......
